25 25
0000000000000000000000000
0001010111101000010101011
1101001010010101000000111
0000101010101111101001010
0000001010101010100101010
1010101011111111111110000
0000000000000000000000000
0111010101001111111111111
0101010100000101000100001
0000000000101111111110010
0101110000101001010101000
0100101010111110010101001
1010101010010101000010101
0101010110101110101010111
1111110101001010010111100
1100100000101010111010001
0111001000100101111000111
0100000111100011101111011
0111111111111110000001111
1000000001111111000011111
0111111111111111111111111
1111111111111111111111111
1111111111111111111111111
1111111111111111111111111
0111111111111111111111111
