35 45
010000110001001100111110001110000011110110011
101111100010010111111010010011101000110111101
001001011011010000000001010111101000011000111
110010000001101101110010010010010100101110110
011101110101100101101001001000101011110111100
001110011010010110001100101000111110101101111
001001100000001101111000110010010110101011111
010011111101011001111111000110011001100111111
110100100111001000100110000111011111011100011
011000101000000000010010101001001101010010111
111001100000001010011111100111111111110100011
100010001011010011010111100101101110001001110
000000011010111011101000101101000000101110011
111000110100011101000101101101101110100001100
011001000000011110000111010111000101110010100
010110000010011101101101011111011011000011101
011111110101001001100011110001000000111011011
111011111101011000111001010110100101010011011
100010011010011110100111000001000010010010100
101100111010011001101011001000001010111100000
000001110100001000011110101001010011010111010
101101010111010110110101001111010001000110101
110101010011010001011111000111110001101101111
001010100100001001100010101100111001000011011
100011000010111001100110010001110000101000010
001001010110110111100011101100010010011001100
010000111000100110110100110011110110110001110
000000101001111011001100111100011011010101010
001111101101100110001111010111111101100010011
011111001000001000001111000101110101111101001
111001001101101000100011011000111000011100000
000000010010111010100110001110000101111100010
101011011000100110110111010101001110001011100
010100010100001000011110100111010111011000100
111001010100010000011111110100100010001101011
