35 45
100110001100010111001010101010011010000100000
001100110010000001100011011010001110000110110
100010001100111011001011111100000011001110011
100011111101111010101100101011011011001000110
000010100101101011000100010011001001000110111
001010000111011010111001011110001101111001010
111001100111000011100011000100101100010101011
101010011011010100100110111010011010001101001
100000100100101001111010110110010000100100010
011100110000011000000000111111100011001010110
111101101000001001010111100010011001000100111
110101010010011011000110010101100010001100010
010111111000111110001010000101001010100111001
110001101101101101110101111100101010001001011
100001010011010001011000000000101100101101010
001101010010111110010111011111111110110010000
011011010011000110011000111110100111100110110
001010100111001001000011111110001110010000010
010100001001001001101101010101001100010001110
110100111111011001110001001110111000000001101
110000011111101100001100100110100010000001100
100101110000011110100110100111001101000000000
011100110110011110111100111000101101110011001
000011111011000000001010101011000000111101000
001000101110111001001110110110011110000110110
001111100101100111101001100010011011111000101
011011111011111000000000101010000010011010100
100001101110000101111101101110110001000011111
100011110001010110001111101101001000001110111
010100001011101011000011000111110000100000011
100100100111111111110001011110010011011111011
100100001110011111100001010110110001111010100
101101000110000100100101011010010010110100111
110100000100001100111011100011011001011010111
110111000011100000011101101010000110100111000
