35 45
001000001100101001010101110010100110101110010
011001001001110100011000011100011111100110000
010011010011100101111001100001111111010011011
100100110011110010100101100100111011111010110
100001111011000001011000100110000101101110110
100000101110110101111111010010100000011101101
111011000001001111000010101101011101100100101
111110000011000010000001100011111101101110111
001110000110010111011110000000111000011101000
001101110110100111011011111110111000100000101
111001000001111011100000110100111001111100111
110110110010111011101101011000101110111101010
000000101001001111001000001001101101101100111
000001000011101011011001111011110011000101101
011001011010101000111100011100111100001110110
110111101101111100001110110111010100100111011
100001010010010111100000110110111111001001101
100110110100101110001110010100100011101000110
100110111100010010001010000101111100011111100
101000011101010111011001010000100101000001001
111001111110111100000000011010010011010001111
000001000110110111111101101111110011011011100
100000111111101110011000001011110011100010110
001001100011101101000010111011010111101010000
000100110010111111001110011111101110111111010
100110111001111001000000111001001011010110011
001001011000110111101111001100001101001011010
011111111010100010001001000101110011010111100
111011000010111100111010111001100011111000111
011000101111110001100000111010011010100111101
011000000011001100001000010100001101101100111
110001011100110110101101100101100010001110110
100110000011010111011001011100010101110110010
000110101011111101101001101110010111010111111
011101111010100110011100011111011110111100111
