35 45
001101000100011100101110100000001000100101101
011100010110111000111011110001110011101001100
110110101010101101001010101011111011110100010
100011100001010100111000100000101100001110001
011111110101000011010100110101110111101000001
101010111011101001000001001001001011110100000
100100000010000110101101011001111101101101001
100001111000011111001111111101100100010010001
011000110000011010110110010001100001100100111
011010001001100111100111101100010001110011101
001010000101010100000010110010100100100100111
000011101000011001101010100011010101011110001
111101100101000010010001111000011001111101111
011110100010111011001101101110100111011011010
110111000011000101001111000011111100010011110
111001111010111111010011110011001110111111101
001011010101100100110000101010110111011011100
000010111100111000100011100100111111100100101
100111100110101100100100111011111101001101011
001110001101010101011101111111000101000100010
010011101000001110000111001011100100110101001
010101110001000101010010110110010001111000000
010001100100101001011010010101100101011000100
000111000111100101101000101101111011111111000
010010000100111010100010011001101010001100011
010001011101001000000101101000011101111010100
011010000001000101100001101101010000010011001
100000000001101000010111010111010011111101111
000010011001001100111001100100001000101110101
011101110100011010000111101010101010100000001
000100100111000111100100111010000011100111000
100101101110001100011011101011000110111011010
110011001101101101000111111001111111011101110
010001100111101101101110101110000010010011111
101011010110101110010110001000100110100001001
