35 45
000001011100101111010011100110011000110111111
010101001011111000001111001000101001111001111
101110100111111110110110111111010101010000111
110000101101000010010110010110111001000101001
011101001101100101101111010010001001000111110
100001100101111110001110111000101001100111110
111100000100110000011001101101010111111010011
101000001010111010000000110111101101110011000
101010010111100111010001001111111100001010101
001110010111000010111001110011001111100011011
000101111000000000111000000000011011101101001
100101011101000001001100011101001001000111100
100100001010101110001010010100010110000000000
000110100111100101111000111101001101100101111
111100110110000010101011011010000010101010100
100011111101000100101000011101010000100111110
101111010010111111111000111000110111101110101
101011100010000100101011010101001111100100011
010010111011001100011101010100001100001101011
111010011000011001101010011100010110011000001
011110110000011000001001010001101110000100010
110110000001111111000011001100101101001101000
010101101100011000011001111110111011001010100
010010111011011111011010011000001010111101011
110011100100111101001011100110101001111100000
101110101110101011111010011100100010110010100
010100101110010011010000100001100111001111110
100111001101101110000110111101001101000101101
100111100010001000101111010001001111010010110
100011000001001001111110111110111011101110110
001011101010100100000101101111000110111010010
011001100110111101101000001000001100110101110
101001110000011111011110001010010110110000000
111110010010111000010101101001101111100100001
101101010111110111001110110110100101000010111
