35 45
110110010010110111011101100111101100011101111
000100110100101001000000001000000010101111111
110001101010001001000101100011101110010100101
101110111011000111011001110001001101010011111
111100110010010000010011010011000101001001000
000110011110110001001010101011110000011011010
000000111000001111011100011001000011100010100
010111011110100001111000010101111101010001011
111010111010000001100110000000010011101111000
001101101001111010010100111100110100011001001
110110000111110010100110110011011100111111001
000100010110110010010000011001101011101100111
001010000011110001110010000110111101100010111
101001101000010101111110010111100010100100000
110111111100100110000000111100110001101011110
000001101001110011100100001101101010100100011
000000111100110011011000001111000011110000011
101011001101110010000011001010001100010100111
000101101001100010001010111010100100101101111
001110001110110011000111111110101000001000010
110000101110100111100001011011010001010001100
001101010001110000101010111000010011011100010
100001100001010001111011011101010111011010001
011110010000101010001101000011000101111110110
010010001101011011000101000011001101100000010
011110100011011000100100001011101000110010111
011010100110110100000100101010010011110100010
100001001100001110010100011101100100111011110
000001001110111011101110100011010000111100100
101110101110101001000010001110000110101111110
000100111000101011110001001110010100010011000
110010000001100001000101001111010010111000101
100011000110101110010111010001111101111010011
001101000111101001111010101010101011110010001
100010001110000111111101101000011110010011100
