35 45
100101100011001111010001000000101110011001100
001011100111100110010110110101010001001011100
101101111000001110101111110110010111110101000
111110011111100001000101110010100110011101111
011001011011001101000111101101011011011000100
000011101001100111001100110100111010111111100
100000001110101011011101110110001110010001000
100011000001101101000100101110001011010111110
111100110001010000111001010011001001011101000
000011111001000110001010011010000010111101011
011101011010100011011111101100110000100000001
111001111001101001101101000000011010111110110
101001010010000010111100100011111010101100101
111011100001000001111001110101011101010100111
010100010010011001101111011001101110001100010
100011100000110010101111010110000010000011111
010001000001001110001001011010001110011011010
100111110011101111001011100011000110001100110
100011000001001001110011111101001101011001111
101000101000101101000000010010011000100011101
111111100001101010011000000111111000011001001
111111011101010111010110110101100000110110101
110110110000001100111110000111111010010001110
100101001000010101110110100011001101010100100
111000010100110110111111001001100011100111001
011000100111101101001011100101000011000000100
101000001110101101110010010110101010011101111
001110001011101011010001110000010110110010011
000010011010110010110100011000000011000000110
100100101000100011010101010100100100001010010
101010100011101010011100111110101000010000100
101010101001110111000101001010000110011101011
111100101001000111001100000000110100011100001
101001110101101000101000010011001100001001001
010011101100011110001111011000101000000011010
