35 45
001000100001111011111010100100011010101111000
111110110111001010011100100110010100111011000
011011011000001101000100111110011111010010001
111011010000010110100110100011000000000001111
101011101101111011001011110000101110000100110
100110001000110100111011101100010101111110101
001101100001101111110101101101000000111110011
000100110100000010110100111011001000011011100
011111110011111110111011010111011110001110000
011011000001100101110100100001011000111011011
001100110100000101110111100111001110010011001
100111100010010001010011110110111100111011011
011101110100000101001101110000110110100011100
000010110110111110010011010000111111011100111
011011111011110000011110100101110110101011101
111010110000010111111010000100000000111111111
111110010010001011000110111111010011100101010
111010000111001010100000101011111011011100111
101001010110010101000001111011011111110000100
010110111001011011010100111101100010101011100
011111001010100001111010101000010011010011110
111111001110100001111110110001011001001010100
011000111011100100101100100101011000011100111
010111100101110000100110001010000000011101101
001101110011000010011101000011110111101111010
111101011111100001011010001011100111110100000
110001000110110111011101111010000101100000110
111101010100110001110101010110100111110010110
101110101001101000000110110101010100000010001
001010101110111110010110100011100110000011101
110101000010101111001000010000000110001101110
100000010111111001101110101001010010010110111
000000100111101000000101100001011011101100000
000111010001110011110011111110001100110001110
111100111000101110110000110111011001000000000
