35 45
001000110001110110111101110001101110000110100
010010100101101110111101010011001000011010000
101100100000100111101000101100110011110011101
110011001111001100111001011100100110010101110
000011011011101110010110010001110101001001100
101010010011111100010110000110101100110110101
100101000111001010111000100101011110001100101
111000001000101010000101110110111111101000100
101011010101011100100000110000011000011000111
101110110011011000011011011011000001010100010
101100010111001011100111011110011101011001000
100011000101111010110111100010100101000000001
101100010111011111101111001101000110110001011
011111011000111111101000000101111010100101011
000010110011101111100101011100100101111100110
011010000011011000010101111111011101110100100
100111111011111110100010111101000110000110000
110001000110110101011000011000000111100010100
000100001111011110101110010101000000011110111
100000100110100101111100110101110000001001010
110101111010010010111001110010110111001000011
001100110000111000111010101111100010101111100
010011001111111001010111011001011100011000000
101011010110010101111111010100111001011100010
011011010000111110001110011100000010101010011
111000101100010000101111001001111101010000000
000100111100011110111000100110111000110110101
110100101000000000010100111010010011001110100
001110101010010110111100011011010101100110100
101000101101100011010110111000110000111000100
001111001000010111011011111110010000100111000
011111000110010100111100001101100111010111101
001111111111100010011010000100101001011001000
111011110101010101100100000101001111011101100
110010011010001011110111000111110001110110010
