35 45
101001001101100111110111110011010101101001110
101000010110001100111000000111111001010001110
101101111011001101001001110110110010001000101
001001011110011000101011000100010010111100101
100000011111100101001010001000101110011001100
101111110101110010011101111100001001111111010
110111110000010000011000101110100111110111111
000111111011110010001001000010111011101011111
000010001010001111111111101010111011001001010
111101110001010011100100101001011100000100101
101001010100100100111111111000001100001010111
001001000011000100100101011100010001011001100
001000100110111010010001100100011010100011010
101101011101101001111111000101110000100011000
111110011101010110001111011110011101101010010
001110101110110100111001101111101100000111001
000101010000011110111000101000111000110001000
011000100001001010010001001001111111111101100
110001000110001100000101010010010111100101011
110010100101010001000000011101010100011001110
111110001110111100011101000000001101000011011
001010011111110111101000100110100001011000110
010111000010011111101101101110000111011011110
000110101101100111011100011101110110000010010
100000000100001001100100000101011100100000100
010000100110000010001000011010101001111010000
110111111101001110110001001001011101011101111
000100011010010010010111010100010110101000000
000001110000000010111111111010111000100100001
110100111111011011000011011011110100001101011
010111011010000101111001001010000111100111011
000111000001011000010100111100111011010011011
001101110100101011110000111111110111101001110
110101101000011100010110101000001100111110000
001001110001000000010000111101110010000101011
